00000000000000000000
00000000000000000000
00000000000000000000
00000000000000000000
00000000000000000000
00000122230000000000
22222777772222222222
77777777777777777777
